NO ./textures/brick.xpm
SO ./textures/blue.xpm
EA ./textures/grey.xpm
WE ./textures/wood.xpm

C       64,128,192
F 32,128,64

1111111111111111111111111111111111111111111111111111
100000010001000000010000000001000010000000000000001
100000011011000000000001000001000010000000000000001
100000000000000000011111111111110111111111111111111
101100000000000000000000000000000010000000000000001
1010011110011111111111111110001111111111111111111111
1000010000001           1000001
111001000S001          110111011
1111111111111         10000000001
                       111111111
