NO ./textures/N.xpm
SO ./textures/S.xpm
EA ./textures/E.xpm
WE ./textures/W.xpm

C       64,128,192
F 32,128,64

11111
10001
10101
10N01
11111
