NO ./textures/brick.xpm
SO ./textures/blue.xpm
EA ./textures/grey.xpm
WE ./textures/wood.xpm

C       64,128,192
F 32,128,64

1111111
1010101
1000001
100N011
1000001
1011101
1111111
